*XXXXXXXXX
***XXXXXXX
XX*XXXXXXX
XX*XXXXXXX
XX***XXXXX
XXXX*XXXXX
XXXX*XXXXX
XXXX***XXX
XXXXXX*XXX
XXXXXX****
